00001110000000100100
11100011101110001111
11111000101000111000
00001110101100010010
01011000101111000110
00001110000110011110
11011100110110111000
00011110110111111101
01011011110110100001
01000000000110110111
11011011010010000000
01010010011000101011
01111000101110101110
00001110000111011001
01101011101101000011
11000110100111011010
01110000100100110011
11010111110110000000
01110100011000111110
00011001000011100010